1111111111111111111111111
10CE000000000000000000001
10000000000C0000000000001
1000P0000000000C000000000
1111111111111111111111111

