1111111111111


1PCE000000111
1111111111111

