111111111111111111111111111111
10CE00000000000000000000000001
100000000000000000000C00000001
1000P0000000000000C00000000001
111111111111111111111111111111

