1111111
1C00001
1000001
100P001
1000001
10000E1
1111111