11111111111
1E0000000C1
111PC000001
11111111111