1111111
100E001
100P001
1110101
10C1001
10CCC01
1111111