1111111
1E00001
111PC01
1111111