11111111111111111111111111111
1000E000000000000000000000001
10000000000000000000000000001
1P000000000000000000000000001
10000000000000000000000000001
1000000000C000000000000000001
10000100000000000000000000011
11111111111111111111111111111